1111111111111111111111111111111111111111
1000000000000000000000000000000000000001
1000000000000000000000000000000000000001
1000000000000000000000000000000000000001
1000000000000000000000000000000000000001
1000000000000000000000000000000000111111
1000000000000000000000000000000000100001
10000000000000000000000000000000001011C1
1000000000000000000000000000000000101111
1000000000000000000000000000000000100001
1000000000000000000000000000000011111101
1000000000000000000000000000000000100001
1000000000000000000000000000000010110111
1E00000000000000000000000000000010101101
1000000000000000000000000000000010101101
1000000000000000000000000000000010000001
1000000000000000000000000000000011111101
10000000000000C0000000000000000000000101
10000000000000000000000000000000000001P1
1111111111111111111111111111111111111111
