1111111111111111111111111111111111111111
1000000000000000000000000001110000010001
1001101111010111111111011100000101000101
10011001100101100100C1001011111111111101
10011011111101001101011010010011001C0001
1001100010010110010001001101101100111111
1011110000010000010001000001001100100001
101C1111111110111101010101110111001011C1
1010000000000000000111110000001100101111
1011111111111111111100110111100000100001
1000000000000111000101110010101111111101
1000111000000111000100000010101000000001
1000111001110000000101111010100010101111
1E0000000111000110010100000000101C101101
1000000000000111000101001111101011101101
1000001110000000000101101C00111010000001
1011001110011111000100001110111011111101
10110011100000C1000111111000111000000101
100000000001111100000000001011111111C1P1
1111111111111111111111111111111111111111
