111111
1P0C01
101001
1C0E01
100001
111111
